AAAAAAAAAAAAAAAAAAWWWAAAAAAAAAAAAAAAAAAA
AAAAAAAAAAAAAAAAAAW1WAAAAAAAAAAAAAAAAAAA
AAAAAAAAAAAAAAAAAAWAWAAAAAAAAAAAAAAAAAAA
AAAAAAAAAAAAAAAAAAWAWAAAAAAAAAAAAAAAAAAA
AAAAWWWWWWWWWWWWWWWAWWWWWWWWWWWWWWWAAAAA
AAAAWAAAAAAAAAAAAAAAAAAAAAAAAAAAAAWAAAAA
AAAAWAAAAAAAAAAAAAAAAAAAAAAAAAAAAAWAAAAA
AAAAWAAAAAAAAAAAAAAAAAAAAAAAAAAAAAWAAAAA
AAAAWAAAAAAAAAAAAAAAAAAAAAAAAAAAAAWAAAAA
AAAAWAAAAAAAAAAAAAAAAAAAAAAAAAAAAAWAAAAA
AAAAWAAAAAAAAAAAAAAAAAAAAAAAAAAAAAWAAAAA
AAAAWAAAAAAAAAAAAAAAAAAAAAAAAAAAAAWAAAAA
AAAAWAAAAAAAAAAAAAAAAAAAAAAAAAAAAAWAAAAA
AAAAWAAAAAAAAAAAAAAAAAAAAAAAAAAAAAWAAAAA
AAAAWAAAAAAAAAAAAAAAAAAAAAAAAAAAAAWAAAAA
AAAAWAAAAAAAAAADDDAADDDAAAAAAAAAAAWAAAAA
AAAAWAAAAAAAAAADDBBBBDDAAAAAAAAAAAWAAAAA
AAAAWAAAAAAAAAADDBBBBDDAAAAAAAAAAAWAAAAA
WWWWWAAAAAAAAAAAABBBBAAAAAAAAAAAAAWWWWWW
WCAAAAAAAAAAAAAAABBBBAAAAAAAAAAAAAAAAACW
WWWWWAAAAAAAAAADDBBBBADAAAAAAAAAAAWWWWWW
AAAAWAAAAAAAAAADDBBBBDDAAAAAAAAAAAWAAAAA
AAAAWAAAAAAAAAADDDAADDDAAAAAAAAAAAWAAAAA
AAAAWAAAAAAAAAAAAAAAAAAAAAAAAAAAAAWAAAAA
AAAAWAAAAAAAAAAAAAAAAAAAAAAAAAAAAAWAAAAA
AAAAWAAAAAAAAAAAAAAAAAAAAAAAAAAAAAWAAAAA
AAAAWAAAAAAAAAAAAAAAAAAAAAAAAAAAAAWAAAAA
AAAAWAAAAAAAAAAAAAAAAAAAAAAAAAAAAAWAAAAA
AAAAWAAAAAAAAAAAAAAAAAAAAAAAAAAAAAWAAAAA
AAAAWAAAAAAAAAAAAAAAAAAAAAAAAAAAAAWAAAAA
AAAAWAAAAAAAAAAAAAAAAAAAAAAAAAAAAAWAAAAA
AAAAWAAAAAAAAAAAAAAAAAAAAAAAAAAAAAWAAAAA
AAAAWAAAAAAAAAAAAAAAAAAAAAAAAAAAAAWAAAAA
AAAAWAAAAAAAAAAAAAAAAAAAAAAAAAAAAAWAAAAA
AAAAWAAAAAAAAAAAAAAAAAAAAAAAAAAAAAWAAAAA
AAAAWWWWWWWWWWWWWWAWWWWWWWWWWWWWWWWAAAAA
AAAAAAAAAAAAAAAAAWAWAAAAAAAAAAAAAAAAAAAA
AAAAAAAAAAAAAAAAAWAWAAAAAAAAAAAAAAAAAAAA
AAAAAAAAAAAAAAAAAWCWAAAAAAAAAAAAAAAAAAAA
AAAAAAAAAAAAAAAAAWWWAAAAAAAAAAAAAAAAAAAA