WWWWWWWWWWWWWWWWWWWWWWWWWWWWWWWWWWWWWWWWWWWWWWWWWWWWWWWWWWWWWWWWWWWWWWWWWWWWWWW
WDADADBDADADADADADADADADADADADADADADBDADADADADADADADADADDADADADBDADADADADADADAW
WADAAAAADADADADADADBDADADADADADADADAAAAADADADBDADADADADADDADADADADADADAABAADADW
WDADACADADADADADADADBDADADADADADADADACADADADADADBDAAAAADDADADADADADADABACADADAW
WADAABAADADADADADADAAAAADADADADADADABAAADADADADADADACADADDADADADADADADAAAAADBDW
WDADADADADADADADBDADACADADADADADADADADADADADADADBDAAAAADDADADADADADADADACBDADAW
WADADADADADBDADADADAAAAADADADADBDADADADADADADADADADADADADDADADADADADBDAAAAADADW
WDBDADADADADADADADADADADBDADADADADADADADADADADADADADADBDDADADADADADADADADADADAW
WBDADAAAAADADADADADADADADADADADADADADADBDADADADADADADADADDADADADADADADADBDADADW
WDADADACADADBDADADADADADADADADADADADADADBDADADADADADBDADDADADADADADADADADADADAW
WADADAAAAADADADADADBDBDADADADAAAAADADADADADADAAAAADADBDADDADADADADADADADADADADW
WDADADADADBDADADADADADADADADADACADADADADADBDADACADADADADDADADADADADADADBDADADAW
WADADADBDADADADADADADADADADADAAAAADADADADADADABBAADADADADDAAAAADADADADADADADBDW
WDADADADADADBDADADADADADADADADADADADADADADADADBDADADADADDADACADADADADADADBDADAW
WADADADADADBDADADADADADADADADADADBDADADADADADADADADADADADDAAAAADADADADADADBDADW
WDADADBDADADADADADADADADADADADADADBDAAAAADADADADADADADADDBDADADADAAAAADADADADAW
WADADADADADADADADADADBDADADADADADADADACADADAABAADADADADAAAADADADADACADADADADBDW
WDADADABBDADADAAAAADADADADADADADADADAAAAADADACADADADADAACADADADADAABAADADADADAW
WADADBDADADADADACADADADADADADADADBDADADADADAAAAADADADADAAAADADADADADADADADBDADW
WDADADADBDADADAAAAADADADADADADADADADAAAAADADADADADADBDADDADADADADBDADADADADADAW
WADADADADADADADADADADBDADADADADADADADACADADADADADBDADADADDADADADADADADADBDADADW
WDADADADADADADADADADADADADADBDADADADAAAAADADADADBDADADADDADADADADADADADBDADADAW
WADADADADADBDADADADADADADADADADADADADADBDADADADADADADADAAAADADADADADADADBDADADW
WDADADADADADADADBDADADADADADADADADADADADBDADADADADADADAACADADADADADBDADADADADAW
WBDADAAADADADADADADADADBDADADADAAAAADADADADADADADADADADAAAADADADADADADAAADADBDW
WDBDAA1AADADADADADADADBDADADADADACADADADADADADADBDADADADDADADADADADADAACAADADAW
WADADAAADADADBDADADADADBDADADADAAAAADADADADADADADADADADADDADADBDADADADAAADADADW
WDADBDADADADADADADADADADADADADADADBDADADADADADADADADADADDADADADADBDADADADADADAW
WADADADADADADADADADADBDADADADADADADADADADADADADBDADADADADDADADADADADADADBDADADW
WWWWWWWWWWWWWWWWWWWWWWWWWWWWWWWWWWWWWWWWWWWWWWWWWWWWWWWWWWWWWWWWWWWWWWWWWWWWWWW