WWWWWWWWWWWWWWWWWWWWW
W1AADADADADADADADAACW
WAWAWAWAWAWAWAWAWAWAW
WADDDBDADDDADBDADDDAW
WDWAWAWAWAWAWAWAWAWDW
WAAADADDDDDDDADADAAAW
WDWAWAWDWDWDWAWAWAWDW
WAAADADBDDDBDADADAAAW
WDWDWAWDWDWDWAWAWDWDW
WAAADADBDDDBDADADADAW
WDWAWAWAWBWAWAWAWAWDW
WAAADADBDDDBDADADAAAW
WDWAWAWAWAWAWAWAWAWDW
WAAADBDDDDDDDBDADAAAW
WDWAWDWDWDWDWDWAWAWDW
WADADADADDDADADADADAW
WAWAWAWAWAWAWAWAWAWAW
WCAADADADADADAAADAACW
WWWWWWWWWWWWWWWWWWWWW