AAAAAADADAAAADW
AWBWDWDWBWWWADW
AWAAA1AAAABWDDW
AWAAWWAWWWAWDDW
AAAWADABAWDDADW
DWDWDWWWAWAWDDW
DWDDBDADABAAADW
AWDWAWAWDWWWWDW
AWAAADADADADADW
ABWBDWAWDWDDADW
AAAAAAAAAAAAADW