WWWWWWWWWWWWWWWWWWWWWWWWWWWWWWWWWWWWWWWWWWWWWWWWW
WDAACACACACACACACACACACACACACACACACACACACACACAADW
WAAAAAAAAAAAAAAAAAAAAAAAAAAAAAAAAAAAAAAAAAAAAAAAW
WACACACACACACACACACACACACACACACACACACACACACACACAW
WAAAAAAAAAAAAAAAAAAAAAAAAAAAAAAAAAAAAAAAAAAAAAAAW
WACACACACACACACACACACACACACACACACACACACACACACACAW
WAAAAAAAAAAAAAAAAAAAAAAAAAAAAAAAAAAAAAAAAAAAAAAAW
WACACACACACACACACACACACACACACACACACACACACACACACAW
WAAAAAAAAAAAAAAAAAAAAAAAAAAAAAAAAAAAAAAAAAAAAAAAW
WACACACACACACACACACACACACACACACACACACACACACACACAW
WAAAAAAAAAAAAAAAAAAAAAWAAAAAAAAAAAAAAAAAAAAAAAAAW
WACACACACACACACACACACW1WCACACACACACACACACACACACAW
WAAAAAAAAAAAAAAAAAAAAADAAAAAAAAAAAAAAAAAAAAAAAAAW
WACACACACACACACACACACACACACACACACACACACACACACACAW
WAAAAAAAAAAAAAAAAAAAAAAAAAAAAAAAAAAAAAAAAAAAAAAAW
WACACACACACACACACACACACACACACACACACACACACACACACAW
WAAAAAAAAAAAAAAAAAAAAAAAAAAAAAAAAAAAAAAAAAAAAAAAW
WACACACACACACACACACACACACACACACACACACACACACACACAW
WAAAAAAAAAAAAAAAAAAAAAAAAAAAAAAAAAAAAAAAAAAAAAAAW
WACACACACACACACACACACACACACACACACACACACACACACACAW
WAAAAAAAAAAAAAAAAAAAAAAAAAAAAAAAAAAAAAAAAAAAAAAAW
WACACACACACACACACACACACACACACACACACACACACACACACAW
WAAAAAAAAAAAAAAAAAAAAAAAAAAAAAAAAAAAAAAAAAAAAAAAW
WDAACACACACACACACACACACACACACACACACACACACACACAADW
WWWWWWWWWWWWWWWWWWWWWWWWWWWWWWWWWWWWWWWWWWWWWWWWW