WWWWWWWWWWW
W1ADAWADACW
WAADDDDDAAW
WDDDABADDDW
WADDDWDDDAW
WWDBDBDBDWW
WADDDWDDDAW
WDDDABADDDW
WAADDDDDAAW
WCADAWADACW
WWWWWWWWWWW