WWWWWWWWWWWWWWWWWW
W1AADDAADDAADDAACW
WAAWWDWDDDDWDWWAAW
WAWDAAAABBAAAADWAW
WDWAWWWWDDWWWWAWDW
WDDAWDAABAAADWADDW
WAWAWAWWDDWWAWAWAW
WADAWAWDDDDWAWADAW
WDDADBDDBBDDBDADDW
WDDADADDBBDDADADDW
WADAWAWDDDDWAWADAW
WAWAWAWWDDWWAWAWAW
WDDAWDAAABAADWADDW
WDWAWWWWDDWWWWAWDW
WAWDAAAABBAAAADWAW
WAAWWDWDDDDWDWWAAW
WCAADDAADDAADDAACW
WWWWWWWWWWWWWWWWWW
