AADADADADADADADADADAA
A1DADADADAWADADADADCA
AADADADADADADADADADAA
AADBDADADAWADADADBDAA
AADADADADABADADADADAA
AADADADADAWADADADADAA
AADADADADADADADADADAA
AADADADAWWDWWADADADAA
AADADADAWBBBWADADADAA
AADADADAWBBBWADADADAA
AADADADAWWDWWADADADAA
AADADADADADADADADADAA
AADADADADAWADADADADAA
AADADADADABADADADADAA
AADADADADAWADADADADAA
AADADADADADADADADADAA
AADBDADADAWADADADBDAA
AADADADADADADADADADAA
ACDADADADAWADADADADCA
AADADADADADADADADADAA